RRRRRRRRRRRRRRRRRRRRRRRRRRRRR
R...........................R
R...........................R
R...........................R
R...........................R
R...........................R
R...........................R
R...........................R
R...........................R
R...........................R
R...........................R
R...........................R
R...........................R
R...........................R
R...........................R
R...........................R
R...........................R
R...........................R
R...........................R
R...........................R
R...........................R
R...........@...............R
RRRRRRRRRRRRRRRRRRRRRRRRRRRRR